11111111
11111111
10P0C0E1
11111111
