11111111
11111111
1ECP11
11111111
