11111111
11111111
11111111
11EPC110
11111111
