111111111111111111
10010C1P1100000E11
110001101001C11111
111000J0001100C111
111111111111111111
