111111111111111111
10010C111000001111
10010C1P1100000E11
110001101001C11111
11100000001100C111
111111111111111111
110001101001C11111
11100000001100C111
111111111111111111
10010C111000001111
110001101001C11111
11100000001100C111
111111111111111111
