111111111111111111111111111111111111111
1000000C0000010000000C00000100010000001
10010000000001000000000010000000C000001
10000000001000000P000000000010000000001
1010E001000001000001000100000000E000001
10000001000000001000B000000100000010001
100000C0000010000000001000C000100000001
10000000000001E000C00000000000000100001
111111111111111111111111111111111111111
